いほりや	庵谷	名詞	
ひろき	拓輝	名詞	
とれいと	トレイト	名詞	
ごじ	誤字	名詞	
るいせきわ	累積和	名詞	
ごじょう	5乗	名詞	
せいすうれつ	整数列	名詞	
にじょうわ	二乗和	名詞	
ぐうき	偶奇	名詞	
ゆうしゃこうぼう	遊舎工房	名詞	
せぐめんとき	セグメント木	名詞	
よろ	よろしくお願いいたします．	短縮よみ	
あさ	アサイン	名詞	
ひど	非同期	名詞	
ふかしこう	負荷試行	名詞	
ときなおし	解き直し	名詞	
ろっくまち	ロック待ち	名詞	
ちがい	違い	名詞	
ぶんしょかん	文書間	名詞	
かんれん	関連研究	名詞	
けん	研究	名詞	
とい	問い	名詞	
ちゅうい	注意	名詞	
にちてすと	2値テスト	名詞	
いか	以下	名詞	
すれっど	スレッド	名詞	
その	その	名詞	
ごるーちん	ゴルーチン	名詞	
ごーるーちん	ゴールーチン	名詞	
くべ	Kubernetes	短縮よみ	
くば	Kubernetes	短縮よみ	
ちょくわがた	直和型	名詞	
たすうは	多数派	名詞	
しょうすうは	少数派	名詞	
きょうぷろ	競プロ	名詞	
こうほうごかんせい	後方互換性	名詞	
